#######
#$ @ $#
#     #
#.   .#
#######