 ######
 #@   #
##$** #
# . * #
#######